1111111
1000001
1000001
1002001
1000001
1000001
1111111